00000000000000003000011000000000000000000000000000000
00000000000000001211110000000000000000000000000000000
00000000000013000000010000000000000000000000000000000
00000000000011111111110000000000000000000000000000000
00000000000000100000000000000000000000000000000000000
00000003001111100000000000000000000000000000000000000
00000000000000000000000000000000000000000000000000000
00030001211000000000000000000000000000000000000000000
00100000001000000000000000000000000000000000000000000
40112111111000000000000000000000000000000000000000000
10000100000000000000000000000000000000000000000000050
11111100000000000000000000000000000011111111111111111