00000000000000000000000000000000000000000000000000000
11111111111111111111111111111111111111111111111111111
1000000000000000000000000000000000000000000000000000
1000000000000000000000000000000000000000000000000000
1001111111111111111111111111111111111111111111111100
1000000000000000000000000000000000000000000100000000
1003000000000000003000300030000000003000000100000000
1111111111111111111111111111111111111100011100000000
1000000000000000000000000000000000000000000100000000
1000000000000000000000000000000000000000000100000000
1000001111111111111111111122222111111111111100000000
1000000000000000000000000000000110000000000000000000
1040000000000000000000000000030110000000000000000000
1000011111111111111111111111111110000000000000000000
1000010000000000000000000000000000000000000000000000
1000010000000000000000000000000000000000000000000005
11111100000000000000000000000000000000000000011111111