11111111111111111111111111111111111111111111111111111
00000000000000000000000000000000000000000000000000000
00000000000000000000000000000000000000000000000000000
00000000000000000000000000000000000000000000000000000
00000000000000000000300000000000000000000000000000000
000000000000000000111100000000000000000000000300000000
00000000000000000000000000000000000000000000000000000
00000000000000121110000000000003000000000001100000500
01003010000000000000000000002222220000000301111111111
01112110000000000000000000000000000000001100000000001
40000000000000000000000000000000000000000000000000001
00000000000030000000000000000000000011000000000000001
00010000001210000000000000000000000000000000000000001
00000000000000000000000000000000110000000000000000001
00000000010001000100000000000000000000000000000000001
11111111110101111111111111111111111111111111111111111