000000000000000000013300000000003300000001000000000000000000
000000000000000000010011111111111111111001000000000000000000
000000000000000000011010000000000000000000000000000000000000
111112111110000000010010000000000000000000000000000000000000
100133300010001210010010000000000000000000000000000000000000
100100100010001000010110000000000000000000000000000000000000
100100100011001000010011111111221111111000000000000000000000
100110100010001000110000000000000000001000000000000000000000
140100100010001000110000000000000000001000000000000000000000
100100100010011001110000111111111111101000000000000000000000
100102100010001011112221000000000000001000000000000000000000
100100100010001000000000000030000000301000000000000000000000
100100100012001111111111111111111111111000000000000000000000
100120100000001000000000000000000000000000000000000000000000
100000100000001000000000000000000000000000000000000000000000
100000100000011000000000000000000000001000100000000000000000
111111111111000000000000000000000000000111000000000005000000